R 2121 2121

NO ./texture/64cat.xpm
SO ./texture/64cat.xpm
WE ./texture/64cat.xpm
EA ./texture/64cat.xpm
S ./texture/64cat.xpm

C 211, 211, 211
F 211, 211, 211


111111111111111111111111111111111111111111111111
12222222222222222222222S222222222222222222222221
122222222222222222222222222222222222222222222221
122222222222222222222222222222222222222222222221
122222222222222222222222222222222222222222222221
122222222222222222222222222222222222222222222221
122222222222222222222222222222222222222222222221
122222222222222222222222222222222222222222222221
122222222222222222222222222222222222222222222221
122222222222222222222222222222222222222222222221
122222222222222222222222222222222222222222222221
122222222222222222222222222222222222222222222221
122222222222222222222222222222222222222222222221
122222222222222222222222222222222222222222222221
122222222222222222222222222222222222222222222221
122222222222222222222222222222222222222222222221
122222222222222222222222222222222222222222222221
122222222222222222222222222222222222222222222221
122222222222222222222222222222222222222222222221
122222222222222222222222222222222222222222222221
122222222222222222222222222222222222222222222221
122222222222222222222222222222222222222222222221
122222222222222222222222222222222222222222222221
122222222222222222222222222222222222222222222221
122222222222222222222222222222222222222222222221
122222222222222222222222222222222222222222222221
122222222222222222222222222222222222222222222221
122222222222222222222222222222222222222222222221
122222222222222222222222222222222222222222222221
122222222222222222222222222222222222222222222221
122222222222222222222222222222222222222222222221
122222222222222222222222222222222222222222222221
122222222222222222222222222222222222222222222221
122222222222222222222222222222222222222222222221
122222222222222222222222222222222222222222222221
122222222222222222222222222222222222222222222221
122222222222222222222222222222222222222222222221
122222222222222222222222222222222222222222222221
122222222222222222222222222222222222222222222221
122222222222222222222222222222222222222222222221
122222222222222222222222222222222222222222222221
122222222222222222222222222222222222222222222221
122222222222222222222222222222222222222222222221
122222222222222222222222222222222222222222222221
122222222222222222222222222222222222222222222221
122222222222222222222222222222222222222222222221
122222222222222222222222222222222222222222222221
122222222222222222222222222222222222222222222221
122222222222222222222222222222222222222222222221
122222222222222222222222222222222222222222222221
122222222222222222222222222222222222222222222221
122222222222222222222222222222222222222222222221
122222222222222222222222222222222222222222222221
122222222222222222222222222222222222222222222221
122222222222222222222222222222222222222222222221
122222222222222222222222222222222222222222222221
122222222222222222222222222222222222222222222221
122222222222222222222222222222222222222222222221
122222222222222222222222222222222222222222222221
122222222222222222222222222222222222222222222221
122222222222222222222222222222222222222222222221
122222222222222222222222222222222222222222222221
122222222222222222222222222222222222222222222221
122222222222222222222222222222222222222222222221
122222222222222222222222222222222222222222222221
122222222222222222222222222222222222222222222221
122222222222222222222222222222222222222222222221
122222222222222222222222222222222222222222222221
122222222222222222222222222222222222222222222221
122222222222222222222222222222222222222222222221
122222222222222222222222222222222222222222222221
122222222222222222222222222222222222222222222221
122222222222222222222222222222222222222222222221
122222222222222222222222222222222222222222222221
122222222222222222222222222222222222222222222221
122222222222222222222222222222222222222222222221
122222222222222222222222222222222222222222222221
122222222222222222222222222222222222222222222221
122222222222222222222222222222222222222222222221
122222222222222222222222222222222222222222222221
122222222222222222222222222222222222222222222221
122222222222222222222222222222222222222222222221
122222222222222222222222222222222222222222222221
122222222222222222222222222222222222222222222221
122222222222222222222222222222222222222222222221
122222222222222222222222222222222222222222222221
122222222222222222222222222222222222222222222221
122222222222222222222222222222222222222222222221
122222222222222222222222222222222222222222222221
122222222222222222222222222222222222222222222221
122222222222222222222222222222222222222222222221
122222222222222222222222222222222222222222222221
122222222222222222222222222222222222222222222221
122222222222222222222222222222222222222222222221
122222222222222222222222222222222222222222222221
122222222222222222222222222222222222222222222221
122222222222222222222222222222222222222222222221
122222222222222222222222222222222222222222222221
122222222222222222222222222222222222222222222221
122222222222222222222222222222222222222222222221
122222222222222222222222222222222222222222222221
122222222222222222222222222222222222222222222221
122222222222222222222222222222222222222222222221
122222222222222222222222222222222222222222222221
122222222222222222222222222222222222222222222221
122222222222222222222222222222222222222222222221
122222222222222222222222222222222222222222222221
122222222222222222222222222222222222222222222221
122222222222222222222222222222222222222222222221
122222222222222222222222222222222222222222222221
122222222222222222222222222222222222222222222221
122222222222222222222222222222222222222222222221
122222222222222222222222222222222222222222222221
122222222222222222222222222222222222222222222221
122222222222222222222222222222222222222222222221
122222222222222222222222222222222222222222222221
122222222222222222222222222222222222222222222221
122222222222222222222222222222222222222222222221
122222222222222222222222222222222222222222222221
122222222222222222222222222222222222222222222221
122222222222222222222222222222222222222222222221
122222222222222222222222222222222222222222222221
122222222222222222222222222222222222222222222221
122222222222222222222222222222222222222222222221
122222222222222222222222222222222222222222222221
122222222222222222222222222222222222222222222221
122222222222222222222222222222222222222222222221
122222222222222222222222222222222222222222222221
122222222222222222222222222222222222222222222221
122222222222222222222222222222222222222222222221
122222222222222222222222222222222222222222222221
122222222222222222222222222222222222222222222221
122222222222222222222222222222222222222222222221
122222222222222222222222222222222222222222222221
122222222222222222222222222222222222222222222221
122222222222222222222222222222222222222222222221
122222222222222222222222222222222222222222222221
122222222222222222222222222222222222222222222221
122222222222222222222222222222222222222222222221
122222222222222222222222222222222222222222222221
122222222222222222222222222222222222222222222221
122222222222222222222222222222222222222222222221
122222222222222222222222222222222222222222222221
122222222222222222222222222222222222222222222221
122222222222222222222222222222222222222222222221
122222222222222222222222222222222222222222222221
122222222222222222222222222222222222222222222221
122222222222222222222222222222222222222222222221
122222222222222222222222222222222222222222222221
122222222222222222222222222222222222222222222221
122222222222222222222222222222222222222222222221
122222222222222222222222222222222222222222222221
122222222222222222222222222222222222222222222221
122222222222222222222222222222222222222222222221
122222222222222222222222222222222222222222222221
122222222222222222222222222222222222222222222221
122222222222222222222222222222222222222222222221
122222222222222222222222222222222222222222222221
122222222222222222222222222222222222222222222221
122222222222222222222222222222222222222222222221
122222222222222222222222222222222222222222222221
122222222222222222222222222222222222222222222221
122222222222222222222222222222222222222222222221
122222222222222222222222222222222222222222222221
122222222222222222222222222222222222222222222221
122222222222222222222222222222222222222222222221
122222222222222222222222222222222222222222222221
122222222222222222222222222222222222222222222221
122222222222222222222222222222222222222222222221
122222222222222222222222222222222222222222222221
122222222222222222222222222222222222222222222221
122222222222222222222222222222222222222222222221
122222222222222222222222222222222222222222222221
122222222222222222222222222222222222222222222221
122222222222222222222222222222222222222222222221
122222222222222222222222222222222222222222222221
122222222222222222222222222222222222222222222221
122222222222222222222222222222222222222222222221
122222222222222222222222222222222222222222222221
122222222222222222222222222222222222222222222221
122222222222222222222222222222222222222222222221
122222222222222222222222222222222222222222222221
122222222222222222222222222222222222222222222221
122222222222222222222222222222222222222222222221
122222222222222222222222222222222222222222222221
122222222222222222222222222222222222222222222221
122222222222222222222222222222222222222222222221
122222222222222222222222222222222222222222222221
122222222222222222222222222222222222222222222221
122222222222222222222222222222222222222222222221
122222222222222222222222222222222222222222222221
122222222222222222222222222222222222222222222221
122222222222222222222222222222222222222222222221
122222222222222222222222222222222222222222222221
122222222222222222222222222222222222222222222221
122222222222222222222222222222222222222222222221
122222222222222222222222222222222222222222222221
122222222222222222222222222222222222222222222221
122222222222222222222222222222222222222222222221
122222222222222222222222222222222222222222222221
122222222222222222222222222222222222222222222221
122222222222222222222222222222222222222222222221
122222222222222222222222222222222222222222222221
122222222222222222222222222222222222222222222221
122222222222222222222222222222222222222222222221
122222222222222222222222222222222222222222222221
122222222222222222222222222222222222222222222221
122222222222222222222222222222222222222222222221
122222222222222222222222222222222222222222222221
122222222222222222222222222222222222222222222221
122222222222222222222222222222222222222222222221
122222222222222222222222222222222222222222222221
122222222222222222222222222222222222222222222221
122222222222222222222222222222222222222222222221
122222222222222222222222222222222222222222222221
122222222222222222222222222222222222222222222221
122222222222222222222222222222222222222222222221
122222222222222222222222222222222222222222222221
122222222222222222222222222222222222222222222221
122222222222222222222222222222222222222222222221
122222222222222222222222222222222222222222222221
122222222222222222222222222222222222222222222221
122222222222222222222222222222222222222222222221
122222222222222222222222222222222222222222222221
122222222222222222222222222222222222222222222221
122222222222222222222222222222222222222222222221
122222222222222222222222222222222222222222222221
122222222222222222222222222222222222222222222221
122222222222222222222222222222222222222222222221
122222222222222222222222222222222222222222222221
122222222222222222222222222222222222222222222221
122222222222222222222222222222222222222222222221
122222222222222222222222222222222222222222222221
122222222222222222222222222222222222222222222221
122222222222222222222222222222222222222222222221
122222222222222222222222222222222222222222222221
122222222222222222222222222222222222222222222221
122222222222222222222222222222222222222222222221
122222222222222222222222222222222222222222222221
122222222222222222222222222222222222222222222221
122222222222222222222222222222222222222222222221
122222222222222222222222222222222222222222222221
122222222222222222222222222222222222222222222221
122222222222222222222222222222222222222222222221
122222222222222222222222222222222222222222222221
122222222222222222222222222222222222222222222221
122222222222222222222222222222222222222222222221
122222222222222222222222222222222222222222222221
122222222222222222222222222222222222222222222221
122222222222222222222222222222222222222222222221
122222222222222222222222222222222222222222222221
122222222222222222222222222222222222222222222221
122222222222222222222222222222222222222222222221
122222222222222222222222222222222222222222222221
122222222222222222222222222222222222222222222221
122222222222222222222222222222222222222222222221
122222222222222222222222222222222222222222222221
122222222222222222222222222222222222222222222221
122222222222222222222222222222222222222222222221
122222222222222222222222222222222222222222222221
122222222222222222222222222222222222222222222221
122222222222222222222222222222222222222222222221
122222222222222222222222222222222222222222222221
122222222222222222222222222222222222222222222221
122222222222222222222222222222222222222222222221
122222222222222222222222222222222222222222222221
122222222222222222222222222222222222222222222221
122222222222222222222222222222222222222222222221
122222222222222222222222222222222222222222222221
122222222222222222222222222222222222222222222221
122222222222222222222222222222222222222222222221
122222222222222222222222222222222222222222222221
122222222222222222222222222222222222222222222221
122222222222222222222222222222222222222222222221
122222222222222222222222222222222222222222222221
122222222222222222222222222222222222222222222221
122222222222222222222222222222222222222222222221
122222222222222222222222222222222222222222222221
122222222222222222222222222222222222222222222221
122222222222222222222222222222222222222222222221
122222222222222222222222222222222222222222222221
122222222222222222222222222222222222222222222221
122222222222222222222222222222222222222222222221
122222222222222222222222222222222222222222222221
122222222222222222222222222222222222222222222221
122222222222222222222222222222222222222222222221
122222222222222222222222222222222222222222222221
122222222222222222222222222222222222222222222221
122222222222222222222222222222222222222222222221
122222222222222222222222222222222222222222222221
122222222222222222222222222222222222222222222221
122222222222222222222222222222222222222222222221
122222222222222222222222222222222222222222222221
122222222222222222222222222222222222222222222221
122222222222222222222222222222222222222222222221
122222222222222222222222222222222222222222222221
122222222222222222222222222222222222222222222221
122222222222222222222222222222222222222222222221
122222222222222222222222222222222222222222222221
122222222222222222222222222222222222222222222221
122222222222222222222222222222222222222222222221
122222222222222222222222222222222222222222222221
122222222222222222222222222222222222222222222221
122222222222222222222222222222222222222222222221
122222222222222222222222222222222222222222222221
122222222222222222222222222222222222222222222221
122222222222222222222222222222222222222222222221
122222222222222222222222222222222222222222222221
122222222222222222222222222222222222222222222221
122222222222222222222222222222222222222222222221
122222222222222222222222222222222222222222222221
122222222222222222222222222222222222222222222221
122222222222222222222222222222222222222222222221
122222222222222222222222222222222222222222222221
122222222222222222222222222222222222222222222221
122222222222222222222222222222222222222222222221
122222222222222222222222222222222222222222222221
122222222222222222222222222222222222222222222221
122222222222222222222222222222222222222222222221
122222222222222222222222222222222222222222222221
122222222222222222222222222222222222222222222221
122222222222222222222222222222222222222222222221
122222222222222222222222222222222222222222222221
122222222222222222222222222222222222222222222221
122222222222222222222222222222222222222222222221
122222222222222222222222222222222222222222222221
122222222222222222222222222222222222222222222221
122222222222222222222222222222222222222222222221
122222222222222222222222222222222222222222222221
122222222222222222222222222222222222222222222221
122222222222222222222222222222222222222222222221
122222222222222222222222222222222222222222222221
122222222222222222222222222222222222222222222221
122222222222222222222222222222222222222222222221
122222222222222222222222222222222222222222222221
122222222222222222222222222222222222222222222221
122222222222222222222222222222222222222222222221
122222222222222222222222222222222222222222222221
122222222222222222222222222222222222222222222221
122222222222222222222222222222222222222222222221
122222222222222222222222222222222222222222222221
122222222222222222222222222222222222222222222221
122222222222222222222222222222222222222222222221
122222222222222222222222222222222222222222222221
122222222222222222222222222222222222222222222221
122222222222222222222222222222222222222222222221
122222222222222222222222222222222222222222222221
122222222222222222222222222222222222222222222221
122222222222222222222222222222222222222222222221
122222222222222222222222222222222222222222222221
122222222222222222222222222222222222222222222221
122222222222222222222222222222222222222222222221
122222222222222222222222222222222222222222222221
122222222222222222222222222222222222222222222221
122222222222222222222222222222222222222222222221
122222222222222222222222222222222222222222222221
122222222222222222222222222222222222222222222221
122222222222222222222222222222222222222222222221
122222222222222222222222222222222222222222222221
122222222222222222222222222222222222222222222221
122222222222222222222222222222222222222222222221
122222222222222222222222222222222222222222222221
122222222222222222222222222222222222222222222221
122222222222222222222222222222222222222222222221
122222222222222222222222222222222222222222222221
122222222222222222222222222222222222222222222221
122222222222222222222222222222222222222222222221
122222222222222222222222222222222222222222222221
122222222222222222222222222222222222222222222221
122222222222222222222222222222222222222222222221
122222222222222222222222222222222222222222222221
122222222222222222222222222222222222222222222221
122222222222222222222222222222222222222222222221
122222222222222222222222222222222222222222222221
122222222222222222222222222222222222222222222221
122222222222222222222222222222222222222222222221
122222222222222222222222222222222222222222222221
122222222222222222222222222222222222222222222221
122222222222222222222222222222222222222222222221
122222222222222222222222222222222222222222222221
122222222222222222222222222222222222222222222221
122222222222222222222222222222222222222222222221
122222222222222222222222222222222222222222222221
122222222222222222222222222222222222222222222221
122222222222222222222222222222222222222222222221
122222222222222222222222222222222222222222222221
122222222222222222222222222222222222222222222221
122222222222222222222222222222222222222222222221
122222222222222222222222222222222222222222222221
122222222222222222222222222222222222222222222221
122222222222222222222222222222222222222222222221
122222222222222222222222222222222222222222222221
122222222222222222222222222222222222222222222221
122222222222222222222222222222222222222222222221
122222222222222222222222222222222222222222222221
122222222222222222222222222222222222222222222221
122222222222222222222222222222222222222222222221
122222222222222222222222222222222222222222222221
122222222222222222222222222222222222222222222221
122222222222222222222222222222222222222222222221
122222222222222222222222222222222222222222222221
122222222222222222222222222222222222222222222221
122222222222222222222222222222222222222222222221
122222222222222222222222222222222222222222222221
122222222222222222222222222222222222222222222221
122222222222222222222222222222222222222222222221
122222222222222222222222222222222222222222222221
122222222222222222222222222222222222222222222221
122222222222222222222222222222222222222222222221
122222222222222222222222222222222222222222222221
122222222222222222222222222222222222222222222221
122222222222222222222222222222222222222222222221
122222222222222222222222222222222222222222222221
122222222222222222222222222222222222222222222221
122222222222222222222222222222222222222222222221
122222222222222222222222222222222222222222222221
122222222222222222222222222222222222222222222221
122222222222222222222222222222222222222222222221
122222222222222222222222222222222222222222222221
122222222222222222222222222222222222222222222221
122222222222222222222222222222222222222222222221
122222222222222222222222222222222222222222222221
122222222222222222222222222222222222222222222221
122222222222222222222222222222222222222222222221
122222222222222222222222222222222222222222222221
122222222222222222222222222222222222222222222221
122222222222222222222222222222222222222222222221
122222222222222222222222222222222222222222222221
122222222222222222222222222222222222222222222221
122222222222222222222222222222222222222222222221
122222222222222222222222222222222222222222222221
122222222222222222222222222222222222222222222221
122222222222222222222222222222222222222222222221
122222222222222222222222222222222222222222222221
122222222222222222222222222222222222222222222221
122222222222222222222222222222222222222222222221
122222222222222222222222222222222222222222222221
122222222222222222222222222222222222222222222221
122222222222222222222222222222222222222222222221
122222222222222222222222222222222222222222222221
122222222222222222222222222222222222222222222221
122222222222222222222222222222222222222222222221
122222222222222222222222222222222222222222222221
122222222222222222222222222222222222222222222221
122222222222222222222222222222222222222222222221
122222222222222222222222222222222222222222222221
122222222222222222222222222222222222222222222221
122222222222222222222222222222222222222222222221
122222222222222222222222222222222222222222222221
122222222222222222222222222222222222222222222221
122222222222222222222222222222222222222222222221
122222222222222222222222222222222222222222222221
122222222222222222222222222222222222222222222221
122222222222222222222222222222222222222222222221
122222222222222222222222222222222222222222222221
122222222222222222222222222222222222222222222221
122222222222222222222222222222222222222222222221
122222222222222222222222222222222222222222222221
111111111111111111111111111111111111111111111111
