R 4294967 4294967

NO ./texture/64cat.xpm
SO ./texture/64cat.xpm
WE ./texture/64cat.xpm
EA ./texture/64cat.xpm
S ./texture/64cat.xpm

C 255, 50, 150
F 255, 0, 150

111111111111111111111111111111111111
122222222222222222222222222222222221
10S000000000000000000000000000000001
122222222222222222222222222222222221
122222222222222222222222222222222221
122222222222222222222222222222222221
122222222222222222222222222222222221
122222222222222222222222222222222221
122222222222222222222222222222222221
122222222222222222222222222222222221
122222222222222222222222222222222221
122222222222222222222222222222222221
122222222222222222222222222222222221
122222222222222222222222222222222221
122222222222222222222222222222222221
122222222222222222222222222222222221
122222222222222222222222222222222221
122222222222222222222222222222222221
122222222222222222222222222222222221
122222222222222222222222222222222221
122222222222222222222222222222222221
122222222222222222222222222222222221
122222222222222222222222222222222221
122222222222222222222222222222222221
122222222222222222222222222222222221
122222222222222222222222222222222221
122222222222222222222222222222222221
122222222222222222222222222222222221
122222222222222222222222222222222221
122222222222222222222222222222222221
122222222222222222222222222222222221
122222222222222222222222222222222221
122222222222222222222222222222222221
122222222222222222222222222222222221
122222222222222222222222222222222221
122222222222222222222222222222222221
122222222222222222222222222222222221
122222222222222222222222222222222221
122222222222222222222222222222222221
122222222222222222222222222222222221
122222222222222222222222222222222221
122222222222222222222222222222222221
122222222222222222222222222222222221
122222222222222222222222222222222221
122222222222222222222222222222222221
122222222222222222222222222222222221
122222222222222222222222222222222221
122222222222222222222222222222222221
122222222222222222222222222222222221
122222222222222222222222222222222221
122222222222222222222222222222222221
122222222222222222222222222222222221
122222222222222222222222222222222221
122222222222222222222222222222222221
122222222222222222222222222222222221
122222222222222222222222222222222221
122222222222222222222222222222222221
122222222222222222222222222222222221
122222222222222222222222222222222221
122222222222222222222222222222222221
122222222222222222222222222222222221
122222222222222222222222222222222221
122222222222222222222222222222222221
122222222222222222222222222222222221
122222222222222222222222222222222221
122222222222222222222222222222222221
122222222222222222222222222222222221
122222222222222222222222222222222221
122222222222222222222222222222222221
122222222222222222222222222222222221
122222222222222222222222222222222221
122222222222222222222222222222222221
122222222222222222222222222222222221
122222222222222222222222222222222221
122222222222222222222222222222222221
122222222222222222222222222222222221
122222222222222222222222222222222221
122222222222222222222222222222222221
122222222222222222222222222222222221
122222222222222222222222222222222221
122222222222222222222222222222222221
122222222222222222222222222222222221
122222222222222222222222222222222221
122222222222222222222222222222222221
122222222222222222222222222222222221
122222222222222222222222222222222221
122222222222222222222222222222222221
122222222222222222222222222222222221
122222222222222222222222222222222221
122222222222222222222222222222222221
122222222222222222222222222222222221
122222222222222222222222222222222221
122222222222222222222222222222222221
122222222222222222222222222222222221
122222222222222222222222222222222221
122222222222222222222222222222222221
122222222222222222222222222222222221
122222222222222222222222222222222221
122222222222222222222222222222222221
122222222222222222222222222222222221
122222222222222222222222222222222221
122222222222222222222222222222222221
122222222222222222222222222222222221
122222222222222222222222222222222221
122222222222222222222222222222222221
122222222222222222222222222222222221
122222222222222222222222222222222221
122222222222222222222222222222222221
111111111111111111111111111111111111
