R 213123 900

NO texture/noise.xpm
SO texture/noise.xpm
WE texture/noise.xpm
EA texture/mine.xpm
S texture/64cat.xpm

C   100, 100, 100
F   150, 150, 150


11111111111111111
10200002000020001
1S002002000020001
10200002020000111
10011001000100011
11111111111111111
