R 1 1

NO texture/cyber.xpm
SO texture/lava.xpm
WE texture/green.xpm
EA texture/mine.xpm
S texture/64cat.xpm

C 12, 21, 21
F 12, 1,1

11111
10001
10S01
10001
11111
