R 3432 1

NO texture/noise.xpm
SO texture/noise.xpm
WE texture/noise.xpm
EA texture/mine.xpm
S texture/64cat.xpm

C   100, 100, 100
F   150, 150, 150


1111111
1020001
1S00201
1111111
