R 1920 1080

NO texture/pink_stones
SO texture/pink_stones
WE texture/pink_stones
EA texture/pink_stones

S texture/sprite_texture

F 153,0,204
C 255,0,204

11111111111111111111111111111
10000110010101001010000000001
10011001001011000010000101001
10011001001011000010000101001
1001100100101100001000N101001
10011001001011000010000101001
10011001001011000010000101001
10011001001011000010000101001
10011001001011000010000101001
10011001001011000010000101001
11111111111111111111111111111

