R 3434 1080

NO texture/t2.xpm
SO texture/green.xpm
WE texture/green.xpm
EA texture/green.xpm

S texture/64cat.xpm

C 153,0,204
F 255,0,20

1111111
110N111
1111111
