R 189098089 1898980

NO texture/grad.xpm
SO texture/grad.xpm
WE texture/grad.xpm
EA texture/grad.xpm
S texture/64cat.xpm

F 255, 150, 150
C 222, 150, 180

11111111111111111
10000000000000001
10000000000000001
10000000000000001
10000000000000001
10000000000000001
10000000000000001
1000000S000000001
10000020200000001
10000000000000001
10000020200000001
10000000000000001
10000020200000001
10000000000000001
10000000000000001
10000000000000001
10000000000000001
10000000000000001
10000000000000001
11111111111111111
