R 189098089 1898980

NO texture/grad.xpm
SO texture/grad.xpm
WE texture/grad.xpm
EA texture/grad.xpm
S texture/item.xpm

F 255, 150, 150
C 222, 150, 180

11111111111111111
12222222S22222221
12222222022222221
12222222022222221
12222222022222221
12222222022222221
12222222022222221
12222222022222221
12222222022222221
12222222022222221
12222222022222221
12222222022222221
12222222022222221
12222222022222221
12222222022222221
12222222022222221
12222222022222221
12222222022222221
12222222022222221
12222222022222221
12222222022222221
11111111111111111
